----------------------------------------------------------------------------------------------------
----------------------------------------------------------------------------------------------------
----------------------------------------------------------------------------------------------------
----------------------------------------------------------------------------------------------------
----------------------------------------------------------------------------------------------------
----------------------------------------------------------------------------------------------------
----------------------------------------------------------------------------------------------------
----------------------------------------------------------------------------------------------------
----------------------------------------------------------------------------------------------------
----------------------------------------------------------------------------------------------------
----------------------------------------------------------------------------------------------------
----------------------------------------------------------------------------------------------------
----------------------------------------------------------------------------------------------------
----------------------------------------------------------------------------------------------------
----------------------------------------------------------------------------------------------------
----------------------------------------------------------------------------------------------------
----------------------------------------------------------------------------------------------------
----------------------------------------------------------------------------------------------------
----------------------------------------------------------------------------------------------------
----------------------------------------------------------------------------------------------------
----------------------------------------------------------------------------------------------------
----------------------------------------------------------------------------------------------------
----------------------------------------------------------------------------------------------------
----------------------------------------------------------------------------------------------------
----------------------------------------------------------------------------------------------------
----------------------------------------------------------------------------------------------------
--------------------------------OOO-----------------------------------------------------------------
-------------------------------OOOOO----------------------------------------------------------------
-----------------------------OOOOOOOOO--------------------------------------------------------------
----------------------------OOOOOOOOOOO-------------------------------------------------------------
---------------------------OOOOOOOOOOOOO------------------------------------------------------------
--------------------------OOOOOOOOOOOOOOO-----------------------------------------------------------
-------------------------OOOOOOOOOOOOOOOOO----------------------------------------------------------
------------------------OOOOOOOOOOOOOOOOOOO---------------------------------------------------------
------------------------OOOOOOOOOOOOOOOOOOO---------------------------------------------------------
-----------------------OOOOOOOOOOOOOOOOOOOOO--------------------------------------------------------
-----------------------OOOOOOOOOOOOOOOOOOOOO--------------------------------------------------------
-----------------------OOOOOOOOOOOOOOOOOOOOO--------------------------------------------------------
------------------------OOOOOOOOOOOOOOOOOOO---------------------------------------------------------
------------------------OOOOOOOOOOOOOOOOOOO---------------------------------------------------------
-------------------------OOOOOOOOOOOOOOOOO----------------------------------------------------------
--------------------------OOOOOOOOOOOOOOO-----------------------------------------------------------
---------------------------OOOOOOOOOOOOO------------------------------------------------------------
----------------------------OOOOOOOOOOO-------------------------------------------------------------
-----------------------------OOOOOOOOO--------------------------------------------------------------
-------------------------------OOOOO----------------------------------------------------------------
--------------------------------OOO-----------------------------------------------------------------
----------------------------------------------------------------------------------------------------
----------------------------------------------------------------------------------------------------
----------------------------------------------------------------------------------------------------
----------------------------------------------------------------------------------------------------
----------------------------------------------------------------------------------------------------
----------------------------------------------------------------------------------------------------
----------------------------------------------------------------------------------------------------
----------------------------------------------------------------------------------------------------
OOOOOOOOOOOOOOOOOOOOOOOOOOOOOOOOOOOOOOOOOOOOOOOOOOOOOOOOOOOOOOOOOOO---------------------------------
OOOOOOOOOOOOOOOOOOOOOOOOOOOOOOOOOOOOOOOOOOOOOOOOOOOOOOOOOOOOOOOOOOO---------------------------------
OOOOOOOOOOOOOOOOOOOOOOOOOOOOOOOOOOOOOOOOOOOOOOOOOOOOOOOOOOOOOOOOOOO---------------------------------
OOOOOOOOOOOOOOOOOOOOOOOOOOOOOOOOOOOOOOOOOOOOOOOOOOOOOOOOOOOOOOOOOOO---------------------------------
OOOOOOOOOOOOOOOOOOOOOOOOOOOOOOOOOOOOOOOOOOOOOOOOOOOOOOOOOOOOOOOOOOO---------------------------------
OOOOOOOOOOOOOOOOOOOOOOOOOOOOOOOOOOOOOOOOOOOOOOOOOOOOOOOOOOOOOOOOOOO---------------------------------
OOOOOOOOOOOOOOOOOOOOOOOOOOOOOOOOOOOOOOOOOOOOOOOOOOOOOOOOOOOOOOOOOOO---------------------------------
OOOOOOOOOOOOOOOOOOOOOOOOOOOOOOOOOOOOOOOOOOOOOOOOOOOOOOOOOOOOOOOOOOO---------------------------------
OOOOOOOOOOOOOOOOOOOOOOOOOOOOOOOOOOOOOOOOOOOOOOOOOOOOOOOOOOOOOOOOOOO---------------------------------
OOOOOOOOOOOOOOOOOOOOOOOOOOOOOOOOOOOOOOOOOOOOOOOOOOOOOOOOOOOOOOOOOOO---------------------------------
OOOOOOOOOOOOOOOOOOOOOOOOOOOOOOOOOOOOOOOOOOOOOOOOOOOOOOOOOOOOOOOOOOO---------------------------------
OOOOOOOOOOOOOOOOOOOOOOOOOOOOOOOOOOOOOOOOOOOOOOOOOOOOOOOOOOOOOOOOOOO---------------------------------
