|||||||||||||||||||||||||||||||||||||||||||||||||||||||||||||||||-----
|OOOOO|||||-----|||||||||||||||||||||||-----|||||-----|||||-----|-----
|OOOOO|||||-----|||||||||||||||||||||||-----|||||-----|||||-----|-----
|OOOOO|||||-----|||||||||||||||||||||||-----|||||-----|||||-----|-----
|OOOOO|||||-----|||||||||||||||||||||||-----|||||-----|||||-----|-----
|OOOOO|||||-----|||||||||||||||||||||||OOOOO|||||-----|||||-----|-----
|OOOOO|||||-----|||||||||||||||||||||||OOOOO|||||-----|||||-----|-----
|OOOOO|||||-----|||||||||||||||||||||||OOOOO|||||-----|||||-----|-----
|OOOOO|||||-----|||||||||||||||||||||||OOOOO|||||-----|||||-----|-----
|OOOOO|||||OOOOO|||||||||||||||||||||||OOOOO|||||-----|||||-----|-----
|OOOOO|||||OOOOO|||||||||||||||||||||||OOOOO|||||-----|||||-----|-----
|OOOOO|||||OOOOO|||||||||||||||||||||||OOOOO|||||OOOOO|||||OOOOO|-----
|OOOOO|||||OOOOO|||||||||||||||||||||||OOOOO|||||OOOOO|||||OOOOO|-----
|OOOOO|||||OOOOO|||||||||||||||||||||||OOOOO|||||OOOOO|||||OOOOO|-----
|OOOOO|||||OOOOO|||||||||||||||||||||||OOOOO|||||OOOOO|||||OOOOO|-----
|OOOOO|||||OOOOO|||||||||||||||||||||||OOOOO|||||OOOOO|||||OOOOO|-----
|OOOOO|||||OOOOO|||||||||||||||||||||||OOOOO|||||OOOOO|||||OOOOO|-----
|OOOOO|||||OOOOO|||||||||||||||||||||||OOOOO|||||OOOOO|||||OOOOO|-----
|OOOOO|||||OOOOO|||||||||||||||||||||||OOOOO|||||OOOOO|||||OOOOO|-----
|OOOOO|||||OOOOO|||||||||||||||||||||||OOOOO|||||OOOOO|||||OOOOO|-----
|OOOOO|||||OOOOO|||||||||||||||||||||||OOOOO|||||OOOOO|||||OOOOO|-----
|OOOOO|||||OOOOO|||||||||||||||||||||||OOOOO|||||OOOOO|||||OOOOO|-----
|OOOOO|||||OOOOO|||||||||||||||||||||||OOOOO|||||OOOOO|||||OOOOO|-----
|OOOOO|||||OOOOO|||||||||||||||||||||||OOOOO|||||OOOOO|||||OOOOO|-----
|OOOOO|||||OOOOO|||||||||||||||||||||||OOOOO|||||OOOOO|||||OOOOO|-----
|OOOOO|||||OOOOO|||||||||||||||||||||||OOOOO|||||OOOOO|||||OOOOO|-----
|OOOOO|||||OOOOO|||||||||||||||||||||||OOOOO|||||OOOOO|||||OOOOO|-----
|OOOOO|||||OOOOO|||||||||||||||||||||||OOOOO|||||OOOOO|||||OOOOO|-----
|OOOOO|||||OOOOO|||||||||||||||||||||||OOOOO|||||OOOOO|||||OOOOO|-----
|OOOOO|||||OOOOO|||||||||||||||||||||||OOOOO|||||OOOOO|||||OOOOO|-----
|OOOOO|||||OOOOO|||||||||||||||||||||||OOOOO|||||OOOOO|||||OOOOO|-----
|OOOOO|||||OOOOO|||||||||||||||||||||||OOOOO|||||OOOOO|||||OOOOO|-----
|OOOOO|||||OOOOO|||||||||||||||||||||||OOOOO|||||OOOOO|||||OOOOO|-----
|OOOOO|||||OOOOO|||||||||||||||||||||||OOOOO|||||OOOOO|||||OOOOO|-----
|OOOOO|||||OOOOO|||||||||||||||||||||||OOOOO|||||OOOOO|||||OOOOO|-----
|OOOOO|||||OOOOO|||||||||||||||||||||||OOOOO|||||OOOOO|||||OOOOO|-----
|OOOOO|||||OOOOO|||||||||||||||||||||||OOOOO|||||OOOOO|||||OOOOO|-----
|OOOOO|||||OOOOO|||||||||||||||||||||||OOOOO|||||OOOOO|||||OOOOO|-----
|OOOOO|||||OOOOO|||||||||||||||||||||||OOOOO|||||OOOOO|||||OOOOO|-----
|OOOOO|||||OOOOO|||||||||||||||||||||||OOOOO|||||OOOOO|||||OOOOO|-----
|OOOOO|||||OOOOO|||||||||||||||||||||||OOOOO|||||OOOOO|||||OOOOO|-----
|OOOOO|||||OOOOO|||||||||||||||||||||||OOOOO|||||OOOOO|||||OOOOO|-----
|OOOOO|||||OOOOO|||||||||||||||||||||||OOOOO|||||OOOOO|||||OOOOO|-----
|OOOOO|||||OOOOO|||||||||||||||||||||||OOOOO|||||OOOOO|||||OOOOO|-----
|OOOOO|||||OOOOO|||||||||||||||||||||||OOOOO|||||OOOOO|||||OOOOO|-----
|OOOOO|||||OOOOO|||||||||||||||||||||||OOOOO|||||OOOOO|||||OOOOO|-----
|OOOOO|||||OOOOO|||||||||||||||||||||||OOOOO|||||OOOOO|||||OOOOO|-----
|OOOOO|||||OOOOO|||||||||||||||||||||||OOOOO|||||OOOOO|||||OOOOO|-----
|OOOOO|||||OOOOO|||||||||||||||||||||||OOOOO|||||OOOOO|||||OOOOO|-----
|OOOOO|||||OOOOO|||||||||||||||||||||||OOOOO|||||OOOOO|||||OOOOO|-----
|OOOOO|||||OOOOO|||||||||||||||||||||||OOOOO|||||OOOOO|||||OOOOO|-----
|OOOOO|||||OOOOO|||||||||||||||||||||||OOOOO|||||OOOOO|||||OOOOO|-----
|OOOOO|||||OOOOO|||||||||||||||||||||||OOOOO|||||OOOOO|||||OOOOO|-----
|OOOOO|||||OOOOO|||||||||||||||||||||||OOOOO|||||OOOOO|||||OOOOO|-----
|OOOOO|||||OOOOO|||||||||||||||||||||||OOOOO|||||OOOOO|||||OOOOO|-----
|OOOOO|||||OOOOO|||||||||||||||||||||||OOOOO|||||OOOOO|||||OOOOO|-----
|OOOOO|||||OOOOO|||||||||||||||||||||||OOOOO|||||OOOOO|||||OOOOO|-----
|OOOOO|||||OOOOO|||||||||||||||||||||||OOOOO|||||OOOOO|||||OOOOO|-----
|OOOOO|||||OOOOO|||||||||||||||||||||||OOOOO|||||OOOOO|||||OOOOO|-----
|OOOOO|||||OOOOO|||||||||||||||||||||||OOOOO|||||OOOOO|||||OOOOO|-----
|OOOOO|||||OOOOO|||||||||||||||||||||||OOOOO|||||OOOOO|||||OOOOO|-----
|OOOOO|||||OOOOO|||||||||||||||||||||||OOOOO|||||OOOOO|||||OOOOO|-----
|OOOOO|||||OOOOO|||||||||||||||||||||||OOOOO|||||OOOOO|||||OOOOO|-----
|OOOOO|||||OOOOO|||||||||||||||||||||||OOOOO|||||OOOOO|||||OOOOO|-----
|OOOOO|||||OOOOO|||||||||||||||||||||||OOOOO|||||OOOOO|||||OOOOO|-----
|OOOOOOOOOOOOOOOOOOOOOOOOOOOOOOOOOOOOOOOOOOOOOOOOOOOOOOOOOOOOOOO|-----
|OOOOOOOOOOOOOOOOOOOOOOOOOOOOOOOOOOOOOOOOOOOOOOOOOOOOOOOOOOOOOOO|-----
